NO imgs/wall.png 
SO imgs/wall.png 
EA imgs/wall.png
WE imgs/wall.png

C 35,19,73
F 15,6,40

111111111111111
111111000111111
11111000011111
1111000N0001111
11100010000111
1100000001000011
1000001D10001
1111111011111
110000000000011
111000000000111
111100000001111
111110000011111
111111000111111
111111111111111