NO main.c
SO main.c


EA main.c



WE main.c
F 77,100,0
C 225,30,255

        111111111111111111111                    
        1000000000100000000001 
        1000000000100000000001
        1001000000000000000001
111111111000000000000000000001   
100000000000111111111111111111
1111111111000001
1111111111111111
                                  111
                                  101
                                   1
111111111111111111111111111111
111111111111111111111000000001
111111111111111111111000000001
1000000000000000000N1101100011
100000000000000000001101100011
11111111111111111111111111111
