NO ./path_to_the_north_texture   
SO ./path_to_the_south_texture


EA ./path_to_the_east_texture



WE ./path_to_the_west_texture
F 220,100,0
C 225,30,0

        1111111111111111111111                        
        1000000000100000000001 
        1000000000100000000001
        1001000000000000000001
111111111000000000000000000001   
100000000000111111111111111111
11111111110000000000000000001
111111111111111111111111111111
111111111111111111111000000001
111111111111111111111000000001
100000000000000000001101100011
100000000000000000001101100011
11111111111111111111111111111
