NO eagle.png
SO wall_2.png
EA eagle.png
WE eagle.png

F 0         ,0           ,225
C 225,0,0

11111111111111111111111111
111111000111111           
111110000011111
111100000001111
111000000000111
110000000000011
100001111100001
110000111000011
111000010000111
111100000001111
111110000011111
1111110S0111111
111111111111111
    1