NO imgs/wall.png 
SO imgs/wall.png 
EA imgs/wall.png
WE imgs/wall.png 

C 38, 28, 18
F 45, 30, 20

111111111111111
111111000111111
111110000011111
1111000N0001111
111000000000111
110000000000011
100001111100001
110000111000011
1110000D0000111
111100000001111
111110000011111
111111000111111
111111111111111